11111111111111111111111111111111111111111111111111111
100000000000000000000000E0000000000000000000000000001
10000000000000000000000000000000000000000000000000001
100000000000000000000000000000000000000P0000000000001
10000000000000000000000000000000000000000000000000001
10000000000000000000000000000000000000000000000000001
1000000000000000000000000C0000000000000C0000000000001
10000000000000000000000000000000000000000000000000001
10000000000000000000000000000000000000000000000000001
10000000000000011111111111111111100000000000000000001
10000000000000000000000000000000000000000000000000001
10000000000000000000000000000000000000000000000000001
10000000000000000000000000000000000000000000000000001
10000000000000001111111111111111110000000000000000001
10000000000000000000000000000000000000000000000000001
10000000000000000000000000000000000000000000000000001
10000000000000000000000000000000000000000000000000001
10000000000000000000000000000000000000000000000000001
11111111111111111100000000000000111111111101111000001
10000000000000000000000000000000000000000000000000001
10000000000000000000000000000000000000000000000000001
10000000000000000000000000000000000000000000000000001
10000000000000000000000000000000000000000000000000001
10000000000000000000000000000000000000000000000000001
10000000000000000000000000000000000000000000000000001
10000000000000000000000000000000000000000000000000001
11111111111111111111111111111111111111111111111111111
