1111111111111
1001000000NC1
1000011111001
100011100E011
100000000C0P1
1111111111111
